1110000111
1110000111
1110000111
0000000000
0000000000
0000000000
1100000011
1110000111
1110000111