1110000111
1100000011
1000000001
0000000000
0011111100
1000000010
1000000011
1110001111