1110000111
1110000111
1100000011
0000000011
0000000000
1100000000
1120000211
1110000111