1110000111
1110000111
1100000011
0000000011
0000000000
11000000E0
117PPPP611
1114444111