1100000011
1000000001
1000000001
0000000000
0000000000
0000000000
1000000001
1100000011