1000000111
1000000001
1000000001
0001100000
0001110000
1000000000
1000000011
1110001111