1000000111
1000000001
1000000001
0001100000
0011110000
1110000000
1100000011
1110001111