1000000111
1000000001
1000000001
0001100000
0011111000
1000001100
1000000111
1110001111