1000000111
1000000001
1000000001
0011111000
0001110000
0100000010
1100000011
1110001111