1112021111
1111011111
1000000001
0000000000
0000000000
0000000000
1000000001
1000000001
1111111111
