1110001111
1110001111
1000000001
0000000000
0S000000S0
R000ER000E
1111001111
1111221111