1110001111
1110001111
1000000001
0000000000
0000000000
0000000000
1111001111
1111221111
1111111111
