1110001111
1110001111
1010000011
0000000000
0000000000
0100000001
1111001111
1111111111
1111111111
