1110000111
1119000111
1910000011
0000000000
0000000000
0100000001
1117PP6111
1111111111