1110001111
1110001111
1010000011
0000100000
0001111000
0011111101
1111111111
1111111111