1111111111
1000000001
1000000001
0000000000
0000000000
0000000000
1110000111
1110000111
1110000111
