1111111111
1111111111
1111111111
0000000000
0000000000
0V00000000
1110000111
1110000111