1111111111
1111111111
1111111111
0000000000
0001001000
0073003600
1173003611
1173003611
1173003611
