1111111111
1111111111
1111111111
0000000000
0001001000
007P00P600
117P00P611
117P00P611