1111111111
1111111111
1111111111
0000000000
0000000000
00000000V0
1117PP6111
1117PP6111