1111111111
1111111111
1111111111
0000000000
0000000000
0000000000
1117336111
1117336111