1111111111
1111111111
1111111111
0000000000
0000000000
0000000009
1990000001
1111100111