1111111111
1110000001
1100000036
1000003006
0001144410
0111100000
1111100001
1111111111