1111111111
1110000001
1100000036
1000003006
0001104410
01111L3000
11111L0001
1111111111