1111111111
1110000001
11000000P6
100V00P006
00T1101110
0111100000
1111110001
1111111111