1111111111
1110000001
11000000P6
100000P006
00T1104410
01111LP000
11111L0001
1111111111