1111111111
1111100001
1111100001
0000000000
00000000V0
0000000110
1000T11111
1221111111