1111111111
11V0000001
1110000001
0000000000
0000000000
1000000011
1R0ST0R111
1111111111