1111111111
1110000001
1100000001
1000003000
0001144410
0111100011
1111100011
1111122211