1111111111
1110000001
1100000001
100SE0P0R0
R00114441V
T111100011
1111100011
1111122211