1111111111
1111190091
9999900000
00000SS000
000000000E
R000061990
9T0EP61111
1111111111