1111111111
1111190091
9999900000
0000000000
0000000000
0000061990
9T0EP61111
1111111111