1111111111
1111199991
1111100001
0000000000
0000000000
0011000110
1111121111
1111111111