1111111111
1111100001
1111100001
00000V0000
0011111000
0111000100
1T00000001
1111111111