1111111111
11100000V1
1110000011
1R1S00P00E
0011144410
0111100011
0000T00111
1111111111