1111111111
1111100001
0110000000
0000000000
0000000000
1000V00111
10T1122111
1111111111