1111111111
1111199991
1111100001
0000000000
0000000V00
0011T00110
1111121111
1111111111