1111111111
1110000001
1100000001
100SE0P0R0
R00111111V
0111100011
0000000111
1111111111